125
18 25
#########################
#gggg               GGGG#
###########   ###########
#1111               1111#
#                       #
#  #### ####  ##    1#1 #
# ##11  #11  #  #   ##1 #
# #1    #11  #  # 1# #1 #
# #1    ####  ### ##### #
# ##11   11#  11#   1#1 #
#  #### #### ###     #1 #
#                       #
#    2             2    #
#1111#             #1111#
###########   ###########
#1B1B1B   #   #   b1b1b1#
#B1B                 b1b#
#########################