1395
20 20
#       #  #       #
 # # #        # # # 
     ###    ###     
 # ##  # ## #  ## # 
  #    # 11 #    #  
     # ###### #     
 ##### #    # ##### 
   #   #    #   #   
 #   # # ## # #   # 
#####  #    #  #####
                    
  #######  #######  
#                  #
  #    #    #    #  
   #  # #### #  #   
                    
########    ########
G## ## ##  ## ## ##g
                    
#  #  ## ## ##  #  #
