200
18 18
G#              #g
 # 111111111111 # 
1  #  # Gg #  #  1
##    # 22 #    ##
1     # ## #     1
      # 11 #      
     B# 11 #b     
   ####g##G####   
    1 #    # 1    
b   1 # Bb # 1   B
    1 # ## # 1    
    1        1    
      # 33 #      
      ######      
      B    b      
      #    #      
121212121121212121
b                B